guitarroom



OO Cutaway (行武 学)
H-28 Supreme (岡 健男)
OM-42 Supreme (岡 健男)



texttexttexttexttexttexttexttexttexttexttexttexttexttexttexttexttextv





　

texttexttexttexttexttexttexttexttexttexttexttexttexttexttexttexttextv





　











































































texttexttexttexttexttexttexttexttexttexttexttexttexttexttexttexttextv





　

texttexttexttexttexttexttexttexttexttexttexttexttexttexttexttexttextv





　

texttexttexttexttexttexttexttexttexttexttexttexttexttexttexttexttextv





　





















































































































































































































































































texttexttexttexttexttexttexttexttexttexttexttexttexttexttexttexttextv





　





























































































TOP： 	Premium Adirondack Spruce (Master Plus Grade)

SIDE＆BACK： 	Premium Brazilian Rosewood (Master Plus Grade)

NECK： 	Honduran Mahogany (1-Pieace)

FINGER BOARD： 	Ebony

BRIDGE： 	Ebony

TRIM： 	Herringbone / Ivoroid

PICK GUARD COLOR： 	Tortoise

POSITION MARK： 	Diamond / Square - Abalone

TUNER： 	Waverly / Open-Gear / Nickel

BRACING： 	Forward Shifted Scalloped-X

NUT WIDTH： 	45mm

SCALE： 	645mm

OTHERS 1： 	Lacquer Finish / Head Plate Brazilian Rosewood

OTHERS 2： 	T-Bar Neck Rod / Hide Glue (ニカワ接着)

OTHERS 3： 	Hand Made Guitar / Made In Japan



販売価格：￥1,300,000-税別



































































TOP：	Premium Adirondack Spruce (Master Plus Grade)

SIDE＆BACK：	Premium Brazilian Rosewood (Master Plus Grade)

NECK：	Honduran Mahogany (1-Pieace)

FINGER BOARD：	Ebony

BRIDGE：	Ebony

TRIM：	Solid Abalone / Wood / Ivoloid

ROSSETTE：	Solid Abalone / Wood

PICK GUARD COLOR：	Tortoise

POSITION MARK：	Snowflakes & Cat's Eye - Pearl (Style-42)

TUNER：	Waverly / Open-Gear / Nickel

BRACING：	Forward Shifted Scalloped-X

NUT WIDTH：	45mm

SCALE：	645mm

OTHERS 1：	Lacquer Finish / Long Saddle

OTHERS 2：	HIde Glue (ニカワ接着) / Ebony Rod Neck

OTHERS 3：	Hand Made Custom Guitar / Made In Japan



販売価格：￥1,500,000-税別













































































































































































































































































































































































